########################################
#                                      #
#                      #################
#                                      #
#                                      #
#                                      #
#                                      #
#                                      #
#                                      #
###########                            #
#                                      #
#                        #             #
#                        #             #
#                        #             #
#                        #             #
#                        ###############
#                                      #
#                                      #
#                                      #
########################################